
#   #   #   .   .   .   .   .   .   .   .   .   .   .   .   .   .   .   .   .   #   #   #   #   #   #   #   #   #   

#   .   .   .   #   #   #   #   #   #   #   #   #   #   #   #   #   #   #   #   #   #   #   .   .   .   #   .   #   

#   .   #   #   #   #   .   .   .   .   .   .   .   .   .   .   .   .   .   .   .   .   #   .   #   .   #   .   #   

#   .   #   #   #   #   #   #   #   #   #   #   #   #   #   #   #   #   #   #   #   .   #   .   #   .   #   .   #   

#   .   .   .   .   .   .   .   .   .   .   .   .   .   .   .   .   .   .   .   .   .   #   .   #   .   #   .   #   

#   #   #   #   #   #   #   #   #   #   #   #   #   #   #   #   #   #   #   #   #   .   #   .   #   .   #   .   #   

#   .   .   .   #   #   ^   >   >   >   >   >   >   >   .   .   .   .   .   .   .   .   #   .   #   .   #   .   #   

#   .   #   .   #   #   ^   #   #   #   .   #   #   !   #   #   #   #   #   #   #   #   #   .   #   .   #   .   #   

#   .   #   ^   >   >   >   #   .   .   .   #   #   B   #   .   .   .   .   .   .   .   .   .   #   .   #   .   #   

#   .   #   ^   #   #   .   #   #   #   #   #   #   #   #   #   #   #   #   #   #   #   #   .   #   .   #   .   #   

#   #   #   ^   #   #   .   .   .   .   .   .   .   .   .   .   .   .   .   #   #   #   #   .   #   .   #   .   #   

#   #   #   ^   #   #   #   #   #   #   #   #   #   #   #   #   #   #   .   #   #   .   #   .   #   .   #   .   #   

#   #   #   <   <   <   ^   .   .   .   .   .   .   .   .   .   #   #   .   .   .   .   #   .   #   .   #   .   #   

#   #   #   #   #   #   ^   #   #   #   #   #   #   #   #   .   #   #   #   #   #   #   #   .   #   .   #   .   #   

#   #   #   #   #   #   ^   #   #   #   #   .   .   .   .   .   .   .   .   .   .   .   .   .   #   .   .   .   #   

A   >   >   >   >   >   >   #   #   #   #   #   #   #   #   #   #   #   #   #   #   #   #   #   #   #   #   #   #   
